NO ./sources/texture/north_texture
SO ./sources/texture/south_texture
WE ./sources/texture/west_texture
EA ./sources/texture/east_texture

C 50,255,126
F 20,30,60

        1111111111111111111111111
        1000000000110000000000001
        11011000001110000000000001
        11100100000000000000000001
1111111111111111011000001010000111
1000000001100000111011111111111
111110111111111011100000010001
111111111111111011101010010001
1100000011010101110000001000011
1000000000000000110000001000001
10000W00000000000110101001000001
1100000111010101111101111001111
11110111 1110101    111010001
11111111 1111111 111111111111














