NO ./sources/texture/north_texture
SO ./sources/texture/south_texture
WE ./sources/texture/west_texture
EA ./sources/texture/east_texture

F 230, 100, 0
C 225,30,0

        1111111111111111111111111
        1000000000110000000000001
        11011000001110000000000001
        11100100000000000000000001
111111111111111101100000111000011
1000000001100000111011111111111
1111101111111110111000000N10001
111101111111111011101010010001
110000001101010111000000100001
1000000000000000110000001000001
1000000000000000110101001000101
110000011101010111110111100111
11110111 1110101    111010001
11111111 1111111 111111111111














