NO ./sources/texture/north_texture
SO ./sources/texture/south_texture
WE ./sources/texture/west_texture
EA ./sources/texture/east_texture

F 230       ,    100,0
C 225,30,0

        1111111111111111111111111
        1000000000110000000000001
        1011000001110000000000001
        1001000000000000000000001
111111111011000001110000000000N001
100000000011000001110111111111111
111110111111111011100000010001
111101111111111011101010010001
11000000110101011100000010001
10000000000000001100000010001
10000000000000001101010010001
110000011101010111110111100111
11110111 1110101 101111010001
11111111 1111111 111111111111
