SO ./assets/texture/42.xpm
NO ./assets/texture/42.xpm
WE ./assets/texture/42.xpm
EA ./assets/texture/42.xpm

C 211, 176, 131
F 182, 102, 89

 1111111111111111111111111111111111
1000001000000010000000100000001
100W0000000000000000000000000011
11100010000000000000010000000011
10100000000000000011000000000111
1010101010101010101110000000001111111111
1111111111   11111111111111111111111
