NO ./assets/texture/42.xpm
WE ./assets/texture/42.xpm
EA ./assets/texture/42.xpm
SO ./assets/texture/42.xpm

C 211, 176, 131
F 182, 102, 89

          111111
          1    1
          1    1
11111111111    1111111111111
1           N               1
11111111111    1111111111111
          1    1
          1    1
          1    1
          111111