SO ./assets/texture/42.xpm
NO ./assets/texture/42.xpm
WE ./assets/texture/42.xpm
EA ./assets/texture/42.xpm

C 211, 176, 131
F 182, 102, 89

111111111111111111111111111111111111 1111
1000001000000010000000100000001
100W0000000000000000000000000011
11100010000000000000010000000011
10100000000000000011000000000111
101010101010101010111000000000111111 1111
111111111111111111111111111111111
