NO ./assets/texture/42.xpm
WE ./assets/texture/42.xpm
EA ./assets/texture/42.xpm
SO ./assets/texture/42.xpm

C 211, 176, 131
F 182, 102, 89

  111111111111111111111111111111111    1
1 1W1000000000000000000000000001          1
1111111111111111111111111111111111
