NO            ./assets/texture/ai/north.xpm                       
SO ./assets/texture/ai/south.xpm



WE ./assets/texture/ai/west.xpm   


EA ./assets/texture/ai/east.xpm     

C 211, 176, 131
F 0, 110, 89

  1 11111  1111111111111   1111111111    1111111
 1000001000000010000000100000001          1
100N0000000000          000000000000000011
100100000000000000100000000111            1                        
1110000000000000001100000000011111111
   11  10101010101010101011100000000011
1111111111111111111111111111111111111



