SO ./assets/texture/ai/south.xpm
NO ./assets/texture/ai/north.xpm
WE ./assets/texture/ai/west.xpm
EA ./assets/texture/ai/east.xpm

C 211, 176, 131
F 182, 102, 89


1111111111111111111111111111111       
1000001000000010000000100000001
100E0000000000000000000000000011
100100000000000000100000000111 
10100000000000000011000000000111
10101010101010101011100000000011
1111111111111111111111111111111
