SO ./assets/texture/asmara/cathedral.xpm
NO ./assets/texture/asmara/endamariam.xpm
EA ./assets/texture/asmara/impero.xpm
WE ./assets/texture/asmara/fiat.xpm






C 211, 176, 42
F 182, 102, 89

1111111111111 11111111111111111
1000001000000010000000100000001
100W0000000000000000000000000011
11100010000000000000010000000011
10100000000000000011000000000111
10101010101010101011100000000011
11111111111111111111111111 11111

