NO            ./assets/texture/moreai/north.xpm                       
SO ./assets/texture/moreai/south.xpm              
WE ./assets/texture/moreai/west.xpm   
EA ./assets/texture/moreai/east.xpm     

C 135, 206, 235
F 101, 67, 33


        111111111111111111111111
        1000000000110000001100001
        101100000111000001  10001
        100100000000000001  10001
111111111011000001110000001100001
100000000011000001110111111111111
11110111111111011100000010001
11110111111111011101010010001
11000000110101011100000010001
10000000000000001100000010001
10000000000000001101010000N01
1100000111010101111101111000111
11110111 1110101 101111010001
11111111 1111111 111111111111
