
SO ./assets/texture/wolfenstein/eagle.xpm
NO ./assets/texture/wolfenstein/greystone.xpm
WE ./assets/texture/wolfenstein/mossy.xpm
EA                                ./assets/texture/wolfenstein/wood.xpm


F 00003,41 ,2
C 039,238,143


111111111
100000001
100000001
100000001
100010001
100000001
100000 01
100E01 11
111111 01
       1