
SO ./assets/texture/wolfenstein/eagle.xpm
NO ./assets/texture/wolfenstein/greystone.xpm
WE ./assets/texture/wolfenstein/mossy.xpm
EA  ./assets/texture/wolfenstein/wood.xpm


F 112, 112, 112
C 56, 56, 56


111111111
100000001
100000001
100000001
100010001
100000001
100000 01
100W01 11
111111 01
       1