SO ./assets/texture/wolfenstein/eagle.xpm
NO ./assets/texture/wolfenstein/greystone.xpm
WE ./assets/texture/wolfenstein/mossy.xpm
EA ./assets/texture/wolfenstein/wood.xpm

F 75,108,87
C 173,216, 230

1111111111111111111111111111111111111111111111111111111111111111
1000001000000010000000100000001000000010000000100000001000000001
1000000000000000000000000000000000000000000000000000000000000001
10001000000000000000000000000000000000000000000000000000000000111
10100000000000000000W000000000000000000000000000000000000000000001
10101010101010101010101010101010001010101010101010101010101010111
1110101110101110111010101110101111101010111010101110101111101011
1000101000101010001010101000101000101010001010101000101000101011
1011101011101110101011101011101010101110101011101011101011101011
100000100000001010100010100000100010001010100010100010100000001
1011111011111110101111101011111011101010111010111011101111111011
1000001010000010101000101000001010001010100010101000101000001011
1111101011111010111010101111101011101010111010101110111011111011
1000101010001010001010101000101010001010101010101000101000101011
1010101011101011101010101010101110101110101011101010111010101011
1010101010001000101010101010101000101010101010001010101010101011
1110101011111011101110101110111011101110101110101111101011101011
1000101000001010001010001000001000101010001000101000101000101011
101110100000010101011101011111010101010101110101010111011101011
1000001000000010001010001000001000101000100010001000001000000011
1111111111111111111111111111111111111111111111111111111111111111















